##1: 
+--+--+--+--+--+--+--+--+--+--+--+--+--+--+--+--+--+--+--+--+--+--+--+  +--+--+--+--+--+--+--+--+--+--+--+--+--+--+--+--+--+--+--+--+--+--+--+
|           |     |     |     |     |           |  |        |                          |     |     |        |              |           |     |
+  +--+--+  +  +  +  +  +  +  +  +--+  +--+--+  +  +  +--+  +--+--+--+--+  +  +  +--+  +--+  +--+  +--+  +  +  +--+--+--+  +  +--+--+  +--+  +
|        |     |     |     |  |        |           |     |        |        |  |     |  |        |     |  |  |  |           |        |        |
+--+--+  +--+--+--+--+  +--+  +  +  +--+  +  +--+--+--+  +--+--+  +  +--+--+  +--+  +--+  +--+  +  +  +--+  +  +  +--+--+  +--+--+  +--+--+--+
|     |  |     |     |  |     |  |  |     |     |        |     |  |  |     |  |  |     |  |     |  |        |  |     |           |     |     |
+  +  +  +  +  +--+  +--+  +--+--+  +--+--+--+  +  +--+  +  +  +  +  +  +  +  +  +--+  +  +  +--+--+  +  +--+  +--+  +--+--+--+  +  +  +  +  +
|  |  |     |        |     |     |           |  |  |     |  |        |  |     |     |     |           |  |     |  |        |  |     |  |  |  |
+  +  +--+--+--+  +  +  +--+  +  +--+--+--+--+  +--+  +--+  +--+--+--+--+--+--+--+  +--+--+--+--+  +--+  +--+  +  +--+--+  +  +--+--+  +  +  +
|  |  |     |     |  |        |     |                 |     |                       |  |     |     |           |           |        |     |  |
+  +  +  +  +--+--+--+--+--+--+--+  +  +--+--+--+--+--+  +--+  +--+--+--+  +--+  +--+  +  +  +--+--+--+--+--+--+--+--+--+--+  +--+  +--+--+  +
|  |     |           |  |     |        |                 |  |  |           |           |  |     |        |        |  |     |  |     |     |  |
+  +  +--+--+--+  +  +  +  +  +  +--+--+  +--+--+  +--+--+  +  +  +--+--+--+  +--+--+  +  +--+  +--+  +--+  +--+  +  +  +  +  +--+--+  +  +  +
|  |  |           |     |  |  |        |        |           |  |  |                 |     |        |     |  |  |  |  |  |  |           |  |  |
+  +--+  +--+  +--+--+--+  +  +--+--+  +--+  +  +--+--+--+--+  +--+  +--+--+--+  +--+--+--+--+--+  +--+  +  +  +  +  +  +  +--+  +--+--+  +--+
|     |     |  |     |     |        |     |  |                 |     |  |     |  |     |  |     |  |     |  |     |     |        |     |     |
+--+  +--+  +  +  +  +  +--+--+--+  +--+  +--+--+--+--+--+--+--+  +--+  +  +  +  +  +  +  +  +  +  +  +--+  +--+--+--+  +  +--+--+  +  +--+  +
|  |     |  |     |  |  |        |  |     |              |     |     |  |  |     |  |  |     |  |        |  |           |     |     |     |  |
+  +--+  +  +--+--+  +  +  +  +--+  +  +--+  +--+--+--+  +  +--+--+  +  +  +--+--+  +  +--+--+  +  +--+  +  +--+--+--+--+--+  +  +--+--+--+  +
|  |     |  |  |     |     |     |  |  |  |  |     |  |        |     |  |  |     |  |        |     |     |  |           |        |           |
+  +  +--+  +  +  +--+--+--+--+  +  +  +  +  +--+  +  +--+--+  +--+  +  +  +--+  +  +--+  +  +--+--+--+--+  +  +--+  +  +--+  +--+  +--+--+  +
|  |     |     |  |     |        |  |     |     |  |  |     |     |     |     |     |     |  |     |        |     |  |        |     |     |  |
+  +--+  +--+  +  +  +  +--+--+  +  +  +--+--+  +  +  +  +--+--+  +  +--+--+  +--+--+--+--+  +  +  +  +--+--+--+  +  +--+--+--+  +  +  +  +--+
|        |     |  |  |  |        |  |  |        |              |  |  |     |              |     |  |           |  |  |     |  |  |  |  |     |
+--+--+--+  +--+--+  +  +  +--+--+  +  +  +--+--+--+  +--+--+  +  +  +  +--+--+--+--+  +--+  +--+  +  +--+--+  +  +  +  +  +  +  +  +--+--+  +
|        |        |  |     |     |     |  |           |     |  |  |     |           |           |  |  |     |  |  |  |  |     |  |        |  |
+  +  +--+  +  +  +  +--+--+  +  +--+  +  +--+  +--+--+  +  +  +  +--+--+  +--+--+  +--+--+--+  +--+  +  +  +  +  +  +  +  +--+  +--+  +  +  +
|  |        |  |  |  |  |     |        |        |        |     |        |  |        |        |  |     |  |     |  |  |  |     |  |     |  |  |
+  +--+--+--+  +  +  +  +  +--+--+--+--+--+--+--+  +--+--+--+--+--+--+  +--+  +--+--+  +--+  +  +  +--+  +--+--+  +  +  +  +  +  +--+--+  +  +
|        |     |     |        |        |        |                 |  |        |        |     |  |  |  |        |  |  |  |  |  |        |  |  |
+--+--+  +  +--+--+--+  +--+  +--+--+  +--+--+  +--+  +--+--+--+  +  +--+--+--+--+--+  +  +--+--+  +  +--+--+  +  +  +--+  +--+--+--+  +  +  +
|     |  |  |     |     |  |           |     |     |  |        |           |     |     |  |     |  |        |  |  |        |     |     |     |
+  +  +  +--+  +  +  +--+  +--+--+--+--+  +  +--+  +  +  +--+  +--+--+--+  +--+  +  +--+  +  +  +  +  +--+  +  +  +--+--+--+  +  +  +--+--+  +
|  |  |  |     |  |                 |     |     |     |  |           |  |        |     |  |  |     |     |  |  |     |     |  |  |        |  |
+  +  +  +  +--+  +  +--+  +--+--+--+  +  +--+  +--+--+  +  +--+--+  +  +  +--+  +--+--+  +  +--+--+--+  +--+  +--+  +  +  +--+  +  +--+  +--+
|  |     |  |     |  |  |  |     |     |  |        |     |     |  |  |  |     |  |     |  |     |        |     |     |  |  |     |     |     |
+  +  +--+  +  +--+  +  +  +  +  +  +--+--+  +--+  +  +--+--+  +  +  +  +--+  +--+  +  +  +--+  +  +--+--+  +--+--+--+  +  +  +--+--+  +--+  +
|  |        |     |  |  |     |     |     |     |        |     |  |  |  |        |  |  |     |  |        |        |     |           |     |  |
+  +--+--+--+--+  +  +  +--+--+--+--+  +  +--+  +--+--+  +  +--+  +  +  +  +--+  +  +  +--+  +  +--+  +  +  +--+  +  +--+--+--+--+  +--+  +  +
|  |     |        |  |     |     |     |        |     |  |     |        |     |  |  |  |     |     |  |     |     |  |     |        |     |  |
+  +  +  +  +--+  +  +--+  +  +  +  +--+--+--+--+  +--+  +--+  +--+--+--+--+  +  +  +  +  +  +--+  +  +--+--+--+--+  +  +  +  +  +--+--+  +  +
|  |  |  |  |     |  |        |  |  |        |  |  |     |     |        |     |  |  |     |     |  |  |     |     |  |  |  |  |  |     |  |  |
+--+  +  +--+  +--+  +  +  +--+--+  +  +--+  +  +  +  +--+--+--+  +--+  +  +--+  +--+--+--+--+  +  +--+  +  +  +  +  +  +  +--+  +  +  +  +  +
|     |     |     |     |  |     |     |  |  |     |           |     |  |     |           |     |        |  |  |  |  |  |     |  |  |     |  |
+  +--+--+  +--+  +  +--+--+  +  +--+  +  +  +  +--+--+--+--+  +--+  +  +  +  +--+  +--+  +  +--+--+--+--+  +  +  +  +  +--+  +  +  +--+--+  +
|  |     |  |     |  |        |        |     |           |     |     |  |  |  |  |     |        |     |     |  |  |  |     |  |  |  |        |
+  +  +  +  +  +--+  +  +--+--+--+--+  +--+--+--+--+--+  +  +--+  +  +  +--+  +  +--+  +--+--+  +  +--+  +--+  +  +  +--+  +  +--+  +  +--+  +
|     |  |     |  |  |     |     |     |  |     |     |  |  |     |  |     |  |        |     |  |     |        |  |        |  |     |     |  |
+--+--+  +  +--+  +  +--+  +  +  +  +--+  +  +  +  +  +  +  +  +--+--+--+  +  +--+  +  +--+  +  +  +  +--+--+--+  +--+--+--+  +  +--+--+  +  +
|  |     |     |  |  |  |     |  |  |        |     |     |  |  |           |  |     |     |  |     |  |     |     |              |        |  |
+  +  +--+--+  +  +  +  +--+--+  +  +  +--+  +--+--+--+--+  +  +  +--+  +--+  +--+--+--+  +  +  +--+  +  +  +  +  +--+--+--+--+--+  +--+--+  +
|     |     |  |     |        |  |  |     |        |           |  |     |     |        |     |  |     |  |  |  |  |                 |     |  |
+  +--+  +  +  +--+--+  +--+  +  +--+--+--+--+--+  +--+--+--+--+  +--+--+  +--+  +--+  +--+--+--+  +--+  +--+  +--+  +--+--+--+--+--+  +  +  +
|        |  |  |        |     |        |        |  |           |     |        |     |     |        |  |     |        |     |           |  |  |
+--+--+--+--+  +  +  +--+--+--+--+  +--+  +--+  +  +  +--+  +  +--+  +  +--+--+--+  +--+  +--+  +  +  +  +  +--+--+--+--+  +--+  +--+--+--+  +
|  |           |  |     |        |     |     |     |     |  |     |  |  |        |     |  |     |  |     |           |     |     |        |  |
+  +  +--+--+--+  +--+  +  +  +--+--+  +--+  +--+  +--+  +  +--+--+  +  +  +--+  +--+  +  +  +--+  +--+--+--+  +--+  +  +--+  +--+  +--+  +  +
|  |        |     |        |        |  |  |  |  |        |              |     |        |  |  |                    |  |        |     |  |     |
+  +--+--+  +  +--+  +--+--+--+--+  +  +  +  +  +--+--+--+  +--+--+  +--+--+  +--+--+--+  +--+  +  +--+--+--+--+--+  +  +--+--+  +--+  +--+--+
|  |        |  |        |     |     |  |     |     |        |        |        |     |  |  |     |  |     |        |  |     |  |  |           |
+  +  +--+--+  +  +--+--+  +  +  +--+  +  +  +--+  +--+--+--+  +--+--+  +--+--+  +  +  +  +  +--+  +--+  +--+--+  +  +--+  +  +  +  +--+--+  +
|  |     |     |     |     |  |     |  |  |              |     |     |     |     |  |     |     |        |     |  |     |     |     |        |
+  +  +--+  +--+--+  +  +--+  +--+  +  +--+--+--+--+--+  +  +--+  +  +  +  +  +--+  +  +--+  +--+--+--+--+  +  +  +  +  +--+  +--+--+  +  +--+
|  |     |  |        |     |        |        |        |  |     |  |  |  |  |     |  |     |  |              |  |     |        |     |  |     |
+  +--+  +  +--+--+--+--+  +--+--+--+--+--+  +  +--+  +--+--+  +  +--+  +  +--+--+  +  +  +--+  +--+--+  +  +  +--+--+--+--+  +  +  +  +--+--+
|        |           |  |  |           |  |  |  |  |        |  |  |     |        |  |  |        |     |  |  |  |     |     |  |  |  |  |     |
+  +  +--+  +--+--+  +  +  +  +--+--+  +  +  +  +  +--+--+  +  +  +  +--+--+--+  +  +  +--+--+--+  +  +  +  +  +  +  +  +--+  +  +  +  +  +  +
|  |  |     |     |     |  |     |  |     |     |        |  |     |     |     |  |  |  |        |  |  |  |  |  |  |  |        |  |        |  |
+  +  +  +--+  +--+--+--+  +--+  +  +--+  +--+--+--+--+  +  +--+--+--+  +  +  +  +  +  +  +  +  +  +  +  +--+  +--+  +--+--+  +  +--+--+--+  +
|  |  |     |  |     |  |     |        |     |                       |  |  |  |  |  |     |  |  |  |        |        |     |  |  |           |
+  +  +--+  +  +  +  +  +--+  +--+--+  +--+  +  +--+--+--+--+--+--+  +  +  +  +  +  +--+--+--+  +  +--+--+  +--+--+  +  +  +--+  +  +--+--+--+
|  |     |  |  |  |        |           |        |        |        |  |     |  |  |  |  |        |  |     |        |  |  |  |     |  |  |     |
+  +  +  +  +  +  +--+--+--+--+--+--+--+--+--+  +  +--+  +  +--+  +  +--+--+  +  +  +  +  +--+--+--+  +  +--+--+--+  +  +  +  +--+  +  +  +  +
|  |  |  |     |           |        |              |  |     |     |           |     |  |  |  |        |        |     |  |     |  |  |     |  |
+  +  +  +--+--+--+--+--+  +  +--+  +--+--+--+--+--+  +--+--+--+  +--+--+--+--+--+--+  +  +  +  +--+--+--+--+  +  +--+  +--+--+  +  +--+--+  +
|  |  |     |           |  |     |           |     |              |        |     |     |        |     |     |  |  |     |     |  |        |  |
+  +  +--+--+  +--+  +  +  +--+  +--+--+--+  +  +--+--+  +--+--+  +--+  +  +  +  +  +  +--+--+  +  +  +  +  +  +  +  +--+--+  +  +--+--+  +  +
|  |           |  |  |  |     |  |           |        |        |        |  |  |  |  |  |     |     |  |  |     |  |  |        |           |  |
+--+--+--+--+  +  +  +--+  +--+  +--+--+--+  +--+--+  +--+--+  +--+--+--+  +  +  +--+  +  +--+--+--+  +  +--+--+--+  +  +--+--+  +--+--+--+  +
|     |     |     |     |     |           |  |        |     |     |           |           |     |     |                       |     |     |  |
+  +  +  +--+--+--+--+  +  +  +--+--+--+  +  +  +--+--+  +  +--+  +  +--+  +--+--+--+--+--+  +  +--+  +--+--+--+--+--+--+--+  +--+  +  +  +  +
|  |  |           |     |  |           |  |  |        |  |  |     |  |  |           |     |  |     |              |  |     |     |     |     |
+  +  +  +--+  +  +--+--+  +--+--+--+  +  +  +  +--+  +  +  +  +--+  +  +--+--+--+  +  +  +  +--+  +--+  +--+--+  +  +  +  +--+--+--+--+--+  +
|  |  |  |     |        |  |     |     |  |     |     |  |  |     |  |  |              |  |  |  |  |     |        |     |  |  |     |        |
+  +  +  +--+--+  +  +  +--+  +  +  +--+  +--+--+  +  +--+  +--+--+  +  +  +--+--+--+--+--+  +  +  +  +--+  +--+--+--+--+  +  +  +  +  +--+--+
|  |  |  |        |  |  |     |           |     |  |  |     |        |     |              |  |  |  |     |           |     |  |  |     |     |
+  +  +  +  +--+--+--+  +  +--+  +--+--+--+  +  +  +  +  +--+  +  +--+--+--+  +--+--+--+  +  +  +  +--+--+  +--+--+  +  +--+  +  +--+  +  +  +
|  |     |  |        |     |     |     |     |     |        |  |  |           |        |     |     |     |  |     |  |           |  |     |  |
+  +--+--+  +  +--+  +--+  +  +--+  +  +  +--+--+  +--+--+  +  +--+  +--+--+--+  +--+  +--+--+  +--+  +  +  +  +--+  +--+--+--+--+  +--+--+  +
|     |     |  |  |  |     |     |  |  |  |     |  |        |  |     |              |     |     |  |  |     |     |           |     |     |  |
+--+  +  +--+  +  +  +--+--+--+  +--+  +--+  +  +--+  +--+--+  +  +--+--+--+--+--+  +--+--+  +--+  +  +--+--+--+  +--+--+--+  +  +--+  +  +  +
|     |     |  |  |     |              |     |        |     |  |  |     |        |        |        |  |        |              |  |     |     |
+  +--+--+--+  +  +--+  +  +--+--+--+--+  +--+--+--+--+  +  +  +  +  +  +  +  +--+--+--+  +--+--+  +  +  +--+  +--+  +--+--+--+  +  +--+--+--+
|              |        |  |           |        |     |  |     |     |  |  |              |     |  |  |     |     |     |           |     |  |
+--+  +--+  +--+  +--+--+  +--+--+--+  +--+--+  +  +  +  +  +--+--+--+  +  +--+  +--+--+  +  +--+  +  +--+  +--+  +--+  +  +--+--+--+--+  +  +
|     |        |        |                    |     |     |           |  |     |        |              |        |        |                    |
+--+--+--+--+--+--+--+--+--+--+--+--+--+--+--+--+--+--+--+--+--+--+--+  +--+--+--+--+--+--+--+--+--+--+--+--+--+--+--+--+--+--+--+--+--+--+--+
