##4: 
+--+--+--+--+--+--+--+--+--+--+--+--+--+--+--+--+--+--+--+--+--+--+--+@@+--+--+--+--+--+--+--+--+--+--+--+--+--+--+--+--+--+--+--+--+--+--+--+
|           |     |     |     |     |           |  |@@@@@@@@|         @@@@@            |     |     |        |              |           |     |
+  +--+--+  +  +  +  +  +  +  +  +--+  +--+--+  +  +@@+--+@@+--+--+--+--+@@+  +  +--+  +--+  +--+  +--+  +  +  +--+--+--+  +  +--+--+  +--+  +
|        |     |     |     |  |        |           |@@@@@|@@@@@@@@|@@@@@@@@|  |     |  |        |     |  |  |  |           |        |        |
+--+--+  +--+--+--+--+  +--+  +  +  +--+  +  +--+--+--+@@+--+--+@@+@@+--+--+  +--+  +--+  +--+  +  +  +--+  +  +  +--+--+  +--+--+  +--+--+--+
|     |  |     |     |  |     |  |  |     |     |      @@|     |@@|@@|     |  |  |     |  |     |  |        |  |     |           |     |     |
+  +  +  +  +  +--+  +--+  +--+--+  +--+--+--+  +  +--+@@+  +  +@@+@@+  +  +  +  +--+  +  +  +--+--+  +  +--+  +--+  +--+--+--+  +  +  +  +  +
|  |  |     |        |     |     |           |  |  |@@@@@|  |   @@@@@|  |     |     |     |           |  |     |  |        |  |     |  |  |  |
+  +  +--+--+--+  +  +  +--+  +  +--+--+--+--+  +--+@@+--+  +--+--+--+--+--+--+--+  +--+--+--+--+  +--+  +--+  +  +--+--+  +  +--+--+  +  +  +
|  |  |     |     |  |        |     |@@@@@@@@@@@@@@@@@|     |                       |  |     |     |           |           |        |     |  |
+  +  +  +  +--+--+--+--+--+--+--+  +@@+--+--+--+--+--+  +--+  +--+--+--+  +--+  +--+  +  +  +--+--+--+--+--+--+--+--+--+--+  +--+  +--+--+  +
|  |     |           |  |     |@@@@@@@@|                 |  |  |           |           |  |     |        |        |  |     |  |     |     |  |
+  +  +--+--+--+  +  +  +  +  +@@+--+--+  +--+--+  +--+--+  +  +  +--+--+--+  +--+--+  +  +--+  +--+  +--+  +--+  +  +  +  +  +--+--+  +  +  +
|  |  |           |     |  |  |@@@@@@@@|        |           |  |  |                 |     |        |     |  |  |  |  |  |  |           |  |  |
+  +--+  +--+  +--+--+--+  +  +--+--+@@+--+  +  +--+--+--+--+  +--+  +--+--+--+  +--+--+--+--+--+  +--+  +  +  +  +  +  +  +--+  +--+--+  +--+
|     |     |  |     |     |        |@@@@@|  |                 |     |  |     |  |     |  |     |  |     |  |     |     |        |     |     |
+--+  +--+  +  +  +  +  +--+--+--+  +--+@@+--+--+--+--+--+--+--+  +--+  +  +  +  +  +  +  +  +  +  +  +--+  +--+--+--+  +  +--+--+  +  +--+  +
|  |     |  |     |  |  |        |  |@@@@@|              |     |     |  |  |     |  |  |     |  |        |  |           |     |     |     |  |
+  +--+  +  +--+--+  +  +  +  +--+  +@@+--+  +--+--+--+  +  +--+--+  +  +  +--+--+  +  +--+--+  +  +--+  +  +--+--+--+--+--+  +  +--+--+--+  +
|  |     |  |  |     |     |     |  |@@|  |  |     |  |        |     |  |  |     |  |        |     |     |  |           |        |           |
+  +  +--+  +  +  +--+--+--+--+  +  +@@+  +  +--+  +  +--+--+  +--+  +  +  +--+  +  +--+  +  +--+--+--+--+  +  +--+  +  +--+  +--+  +--+--+  +
|  |     |     |  |     |        |  |@@   |     |  |  |     |     |     |     |     |     |  |     |        |     |  |        |     |     |  |
+  +--+  +--+  +  +  +  +--+--+  +  +@@+--+--+  +  +  +  +--+--+  +  +--+--+  +--+--+--+--+  +  +  +  +--+--+--+  +  +--+--+--+  +  +  +  +--+
|        |     |  |  |  |        |  |@@|        |              |  |  |     |              |     |  |           |  |  |     |  |  |  |  |     |
+--+--+--+  +--+--+  +  +  +--+--+  +@@+  +--+--+--+  +--+--+  +  +  +  +--+--+--+--+  +--+  +--+  +  +--+--+  +  +  +  +  +  +  +  +--+--+  +
|        |        |  |     |@@@@@|   @@|  |           |     |  |  |     |           |           |  |  |     |  |  |  |  |     |  |        |  |
+  +  +--+  +  +  +  +--+--+@@+@@+--+@@+  +--+  +--+--+  +  +  +  +--+--+  +--+--+  +--+--+--+  +--+  +  +  +  +  +  +  +  +--+  +--+  +  +  +
|  |        |  |  |  |  |@@@@@|@@@@@@@@|        |        |     |        |  |        |        |  |     |  |     |  |  |  |     |  |     |  |  |
+  +--+--+--+  +  +  +  +@@+--+--+--+--+--+--+--+  +--+--+--+--+--+--+  +--+  +--+--+  +--+  +  +  +--+  +--+--+  +  +  +  +  +  +--+--+  +  +
|        |     |     |@@@@@   |        |        |                 |  |        |        |     |  |  |  |        |  |  |  |  |  |        |  |  |
+--+--+  +  +--+--+--+@@+--+  +--+--+  +--+--+  +--+  +--+--+--+  +  +--+--+--+--+--+  +  +--+--+  +  +--+--+  +  +  +--+  +--+--+--+  +  +  +
|     |  |  |     |@@@@@|  |           |@@@@@|     |  |        |           |     |     |  |     |  |        |  |  |        |     |     |     |
+  +  +  +--+  +  +@@+--+  +--+--+--+--+@@+@@+--+  +  +  +--+  +--+--+--+  +--+  +  +--+  +  +  +  +  +--+  +  +  +--+--+--+  +  +  +--+--+  +
|  |  |  |     |  |@@@@@@@@         |@@@@@|@@@@@|     |  |           |  |        |     |  |  |     |     |  |  |     |     |  |  |        |  |
+  +  +  +  +--+  +  +--+@@+--+--+--+@@+  +--+@@+--+--+  +  +--+--+  +  +  +--+  +--+--+  +  +--+--+--+  +--+  +--+  +  +  +--+  +  +--+  +--+
|  |     |  |     |  |  |@@|@@@@@|@@@@@|  |@@@@@   |     |     |  |  |  |     |  |     |  |     |        |     |     |  |  |     |     |     |
+  +  +--+  +  +--+  +  +@@+@@+@@+@@+--+--+@@+--+  +  +--+--+  +  +  +  +--+  +--+  +  +  +--+  +  +--+--+  +--+--+--+  +  +  +--+--+  +--+  +
|  |        |     |  |  |@@@@@|@@@@@|@@@@@|@@@@@|        |     |  |  |  |        |  |  |     |  |        |        |     |           |     |  |
+  +--+--+--+--+  +  +  +--+--+--+--+@@+@@+--+@@+--+--+  +  +--+  +  +  +  +--+  +  +  +--+  +  +--+  +  +  +--+  +  +--+--+--+--+  +--+  +  +
|  |     |        |  |     |     |@@@@@|@@@@@@@@|     |  |     |        |     |  |  |  |     |     |  |     |     |  |     |        |     |  |
+  +  +  +  +--+  +  +--+  +  +  +@@+--+--+--+--+  +--+  +--+  +--+--+--+--+  +  +  +  +  +  +--+  +  +--+--+--+--+  +  +  +  +  +--+--+  +  +
|  |  |  |  |     |  |        |  |@@|        |  |  |     |     |        |     |  |  |     |     |  |  |     |     |  |  |  |  |  |     |  |  |
+--+  +  +--+  +--+  +  +  +--+--+@@+  +--+  +  +  +  +--+--+--+  +--+  +  +--+  +--+--+--+--+  +  +--+  +  +  +  +  +  +  +--+  +  +  +  +  +
|     |     |     |     |  |@@@@@|@@@@@|  |  |     |           |     |  |     |           |     |        |  |  |  |  |  |     |  |  |     |  |
+  +--+--+  +--+  +  +--+--+@@+@@+--+@@+  +  +  +--+--+--+--+  +--+  +  +  +  +--+  +--+  +  +--+--+--+--+  +  +  +  +  +--+  +  +  +--+--+  +
|  |     |  |     |  |@@@@@@@@|@@@@@@@@|     |           |     |     |  |  |  |  |     |        |     |     |  |  |  |     |  |  |  |        |
+  +  +  +  +  +--+  +@@+--+--+--+--+  +--+--+--+--+--+  +  +--+  +  +  +--+  +  +--+  +--+--+  +  +--+  +--+  +  +  +--+  +  +--+  +  +--+  +
|     |  |     |  |  |@@@@@|@@@@@|     |  |     |     |  |  |     |  |     |  |        |     |  |     |        |  |        |  |     |     |  |
+--+--+  +  +--+  +  +--+@@+@@+@@+  +--+  +  +  +  +  +  +  +  +--+--+--+  +  +--+  +  +--+  +  +  +  +--+--+--+  +--+--+--+  +  +--+--+  +  +
|  |     |     |  |  |  |@@@@@|@@|  |        |     |     |  |  |           |  |     |     |  |     |  |     |     |              |        |  |
+  +  +--+--+  +  +  +  +--+--+@@+  +  +--+  +--+--+--+--+  +  +  +--+  +--+  +--+--+--+  +  +  +--+  +  +  +  +  +--+--+--+--+--+  +--+--+  +
|     |     |  |     |        |@@|  |     |        |           |  |     |     |@@@@@@@@|     |  |     |  |  |  |  |                 |     |  |
+  +--+  +  +  +--+--+  +--+  +@@+--+--+--+--+--+  +--+--+--+--+  +--+--+  +--+@@+--+@@+--+--+--+  +--+  +--+  +--+  +--+--+--+--+--+  +  +  +
|        |  |  |        |     |@@@@@   |        |  |           |     |        |@@@@@|@@@@@|        |  |     |        |     |           |  |  |
+--+--+--+--+  +  +  +--+--+--+--+@@+--+  +--+  +  +  +--+  +  +--+  +  +--+--+--+@@+--+@@+--+  +  +  +  +  +--+--+--+--+  +--+  +--+--+--+  +
|  |           |  |     |        |@@@@@|     |     |     |  |     |  |  |@@@@@@@@|@@@@@|@@|     |  |     |           |     |     |        |  |
+  +  +--+--+--+  +--+  +  +  +--+--+@@+--+  +--+  +--+  +  +--+--+  +  +@@+--+@@+--+@@+@@+  +--+  +--+--+--+  +--+  +  +--+  +--+  +--+  +  +
|  |        |     |        |        |@@|  |  |  |        |              |@@@@@|@@@@@@@@|@@|  |                    |  |        |     |  |     |
+  +--+--+  +  +--+  +--+--+--+--+  +@@+  +  +  +--+--+--+  +--+--+  +--+--+@@+--+--+--+@@+--+  +  +--+--+--+--+--+  +  +--+--+  +--+  +--+--+
|  |        |  |        |     |     |@@|     |     |        |        |@@@@@@@@|     |  |@@|     |  |     |        |  |     |  |  |           |
+  +  +--+--+  +  +--+--+  +  +  +--+@@+  +  +--+  +--+--+--+  +--+--+@@+--+--+  +  +  +@@+  +--+  +--+  +--+--+  +  +--+  +  +  +  +--+--+  +
|  |     |     |     |     |  |     |@@|  |              |     |     |@@   |     |  |@@@@@|     |        |     |  |     |     |     |        |
+  +  +--+  +--+--+  +  +--+  +--+  +@@+--+--+--+--+--+  +  +--+  +  +@@+  +  +--+  +@@+--+  +--+--+--+--+  +  +  +  +  +--+  +--+--+  +  +--+
|  |     |  |        |     |        |@@@@@@@@|@@@@@@@@|  |     |  |  |@@|  |     |  |@@   |  |              |  |     |        |     |  |     |
+  +--+  +  +--+--+--+--+  +--+--+--+--+--+@@+@@+--+@@+--+--+  +  +--+@@+  +--+--+  +@@+  +--+  +--+--+  +  +  +--+--+--+--+  +  +  +  +--+--+
|        |           |  |  |           |  |@@|@@|  |@@@@@@@@|  |  |@@@@@|        |  |@@|        |     |  |  |  |     |     |  |  |  |  |     |
+  +  +--+  +--+--+  +  +  +  +--+--+  +  +@@+@@+  +--+--+@@+  +  +@@+--+--+--+  +  +@@+--+--+--+  +  +  +  +  +  +  +  +--+  +  +  +  +  +  +
|  |  |     |     |     |  |     |  |     |@@@@@|        |@@|     |@@@@@|@@@@@|  |  |@@|@@@@@@@@|  |  |  |  |  |  |  |        |  |        |  |
+  +  +  +--+  +--+--+--+  +--+  +  +--+  +--+--+--+--+  +@@+--+--+--+@@+@@+@@+  +  +@@+@@+  +@@+  +  +  +--+  +--+  +--+--+  +  +--+--+--+  +
|  |  |     |  |     |  |     |        |     |            @@@@@@@@@@@|@@|@@|@@|  |  |@@@@@|  |@@|  |        |        |     |  |  |           |
+  +  +--+  +  +  +  +  +--+  +--+--+  +--+  +  +--+--+--+--+--+--+@@+@@+@@+@@+  +  +--+--+--+@@+  +--+--+  +--+--+  +  +  +--+  +  +--+--+--+
|  |     |  |  |  |        |           |        |        |        |@@|@@@@@|@@|  |  |  |@@@@@@@@|  |     |        |  |  |  |     |  |  |     |
+  +  +  +  +  +  +--+--+--+--+--+--+--+--+--+  +  +--+  +  +--+  +@@+--+--+@@+  +  +  +@@+--+--+--+  +  +--+--+--+  +  +  +  +--+  +  +  +  +
|  |  |  |     |           |        |              |  |     |     |@@@@@@@@@@@|     |  |@@|  |        |        |     |  |     |  |  |     |  |
+  +  +  +--+--+--+--+--+  +  +--+  +--+--+--+--+--+  +--+--+--+  +--+--+--+--+--+--+  +@@+  +  +--+--+--+--+  +  +--+  +--+--+  +  +--+--+  +
|  |  |     |           |  |     |           |     |              |        |     |     |@@@@@@@@|@@@@@|     |  |  |     |     |  |        |  |
+  +  +--+--+  +--+  +  +  +--+  +--+--+--+  +  +--+--+  +--+--+  +--+  +  +  +  +  +  +--+--+@@+@@+@@+  +  +  +  +  +--+--+  +  +--+--+  +  +
|  |           |  |  |  |     |  |           |        |        |        |  |  |  |  |  |     |@@@@@|@@|  |     |  |  |        |           |  |
+--+--+--+--+  +  +  +--+  +--+  +--+--+--+  +--+--+  +--+--+  +--+--+--+  +  +  +--+  +  +--+--+--+@@+  +--+--+--+  +  +--+--+  +--+--+--+  +
|     |     |     |     |     |           |  |        |     |     |           |           |@@@@@|   @@|                       |     |     |  |
+  +  +  +--+--+--+--+  +  +  +--+--+--+  +  +  +--+--+  +  +--+  +  +--+  +--+--+--+--+--+@@+@@+--+@@+--+--+--+--+--+--+--+  +--+  +  +  +  +
|  |  |           |     |  |           |  |  |        |  |  |     |  |  |           |     |@@|@@@@@|@@@@@@@@@@@@@@|  |     |     |     |     |
+  +  +  +--+  +  +--+--+  +--+--+--+  +  +  +  +--+  +  +  +  +--+  +  +--+--+--+  +  +  +@@+--+@@+--+  +--+--+@@+  +  +  +--+--+--+--+--+  +
|  |  |  |     |        |  |     |     |  |     |     |  |  |     |  |  |              |  |@@|  |@@|     |@@@@@@@@|     |  |  |     |        |
+  +  +  +--+--+  +  +  +--+  +  +  +--+  +--+--+  +  +--+  +--+--+  +  +  +--+--+--+--+--+@@+  +@@+  +--+@@+--+--+--+--+  +  +  +  +  +--+--+
|  |  |  |        |  |  |     |           |     |  |  |     |        |     |@@@@@@@@@@@@@@|@@|  |@@|     |@@         |     |  |  |     |     |
+  +  +  +  +--+--+--+  +  +--+  +--+--+--+  +  +  +  +  +--+  +  +--+--+--+@@+--+--+--+@@+@@+  +@@+--+--+@@+--+--+  +  +--+  +  +--+  +  +  +
|  |     |  |        |     |     |     |     |     |        |  |  |@@@@@@@@@@@|        |@@@@@|@@@@@|@@@@@|@@|     |  |           |  |     |  |
+  +--+--+  +  +--+  +--+  +  +--+  +  +  +--+--+  +--+--+  +  +--+@@+--+--+--+  +--+  +--+--+@@+--+@@+@@+@@+  +--+  +--+--+--+--+  +--+--+  +
|     |     |  |  |  |     |     |  |  |  |     |  |        |  |@@@@@|              |     |@@@@@|  |@@|@@@@@|     |           |     |     |  |
+--+  +  +--+  +  +  +--+--+--+  +--+  +--+  +  +--+  +--+--+  +@@+--+--+--+--+--+  +--+--+@@+--+  +@@+--+--+--+  +--+--+--+  +  +--+  +  +  +
|     |     |  |  |     |              |     |        |     |  |@@|@@@@@|        |        |@@@@@@@@|@@|        |              |  |     |     |
+  +--+--+--+  +  +--+  +  +--+--+--+--+  +--+--+--+--+  +  +  +@@+@@+@@+  +  +--+--+--+  +--+--+@@+@@+  +--+  +--+  +--+--+--+  +  +--+--+--+
|              |        |  |           |        |     |  |     |@@@@@|@@|  |              |     |@@|@@|     |     |     |           |     |  |
+--+  +--+  +--+  +--+--+  +--+--+--+  +--+--+  +  +  +  +  +--+--+--+@@+  +--+  +--+--+  +  +--+@@+@@+--+  +--+  +--+  +  +--+--+--+--+  +  +
|     |        |        |                    |     |     |           |@@|     |        |         @@@@@|        |        |                    |
+--+--+--+--+--+--+--+--+--+--+--+--+--+--+--+--+--+--+--+--+--+--+--+@@+--+--+--+--+--+--+--+--+--+--+--+--+--+--+--+--+--+--+--+--+--+--+--+
